Александр: Александрович, Александровна
Дмитрий: Дмитриевич, Дмитриевна
Максим: Максимович, Максимовна
Сергей: Сергеевич, Сергеевна
Андрей: Андреевич, Андреевна
Алексей: Алексеевич, Алексеевна
Артём: Артёмович, Артёмовна
Иван: Иванович, Ивановна
Михаил: Михайлович, Михайловна
Кирилл: Кириллович, Кирилловна
Никита: Никитич, Никитична
Матвей: Матвеевич, Матвеевна
Роман: Романович, Романовна
Егор: Егорович, Егоровна
Тимофей: Тимофеевич, Тимофеевна
Илья: Ильич, Ильинична
Владимир: Владимирович, Владимировна
Ярослав: Ярославович, Ярославовна
Арсений: Арсеньевич, Арсеньевна
Даниил: Даниилович, Данииловна
Евгений: Евгеньевич, Евгеньевна
Глеб: Глебович, Глебовна
Константин: Константинович, Константиновна
Богдан: Богданович, Богдановна
Виктор: Викторович, Викторовна
Станислав: Станиславович, Станиславовна
Савелий: Савельевич, Савельевна
Вадим: Вадимович, Вадимовна
Олег: Олегович, Олеговна
Степан: Степанович, Степановна
Юрий: Юрьевич, Юрьевна
Марк: Маркович, Марковна
Тимур: Тимурович, Тимуровна
Павел: Павлович, Павловна
Артур: Артурович, Артуровна
Фёдор: Фёдорович, Фёдоровна
Георгий: Георгиевич, Георгиевна
Лев: Львович, Львовна
Антон: Антонович, Антоновна
Руслан: Русланович, Руслановна
Вячеслав: Вячеславович, Вячеславовна
Григорий: Григорьевич, Григорьевна
Макар: Макарович, Макаровна
Николай: Николаевич, Николаевна
Пётр: Петрович, Петровна
Василий: Васильевич, Васильевна
Борис: Борисович, Борисовна
Иннокентий: Иннокентьевич, Иннокентьевна
Валерий: Валерьевич, Валерьевна
Ростислав: Ростиславович, Ростиславовна
Семён: Семёнович, Семёновна
Всеволод: Всеволодович, Всеволодовна
Денис: Денисович, Денисовна
Сидор: Сидорович, Сидоровна
Мирон: Миронович, Мироновна
Тихон: Тихонович, Тихоновна
Игнат: Игнатьевич, Игнатьевна
Захар: Захарович, Захаровна
Родион: Родионович, Родионовна
Игорь: Игоревич, Игоревна
Владислав: Владиславович, Владиславовна
Святослав: Святославович, Святославовна
Ян: Янович, Яновна
Мирослав: Мирославович, Мирославовна
Назар: Назарович, Назаровна
Гордей: Гордеевич, Гордеевна
Эдуард: Эдуардович, Эдуардовна
Аркадий: Аркадьевич, Аркадьевна
Тарас: Тарасович, Тарасовна
Анатолий: Анатольевич, Анатольевна
Виталий: Витальевич, Витальевна
Платон: Платонович, Платоновна
Герман: Германович, Германовна
Демид: Демидович, Демидовна
Давид: Давидович, Давидовна
Зиновий: Зиновьевич, Зиновьевна
Ипполит: Ипполитович, Ипполитовна
Казимир: Казимирович, Казимировна
Лаврентий: Лаврентьевич, Лаврентьевна
Леонид: Леонидович, Леонидовна
Лука: Лукич, Лукинична
Мечислав: Мечиславович, Мечиславовна
Наум: Наумович, Наумовна
Нестор: Несторович, Несторовна
Остап: Остапович, Остаповна
Потап: Потапович, Потаповна
Прохор: Прохорович, Прохоровна
Радислав: Радиславович, Радиславовна
Роберт: Робертович, Робертовна
Савва: Саввич, Саввична
Самсон: Самсонович, Самсоновна
Севастьян: Севастьянович, Севастьяновна
Соломон: Соломонович, Соломоновна
Софрон: Софронович, Софроновна
Спартак: Спартакович, Спартаковна
Стахий: Стахиевич, Стахиевна
Стефан: Стефанович, Стефановна
Терентий: Терентьевич, Терентьевна
Трифон: Трифонович, Трифоновна
Трофим: Трофимович, Трофимовна
Устин: Устинович, Устиновна
Филипп: Филиппович, Филипповна
Фома: Фомич, Фоминична
Харитон: Харитонович, Харитоновна
Эраст: Эрастович, Эрастовна
Юлиан: Юлианович, Юлиановна
Яков: Яковлевич, Яковлевна
Ярополк: Ярополкович, Ярополковна
Адам: Адамович, Адамовна
Адриан: Адрианович, Адриановна
Альберт: Альбертович, Альбертовна
Амос: Амосович, Амосовна
Ананий: Ананьевич, Ананьевна
Андроник: Андроникович, Андрониковна
Анисим: Анисимович, Анисимовна
Антип: Антипович, Антиповна
Аполлинарий: Аполлинариевич, Аполлинариевна
Арий: Ариевич, Ариевна
Арнольд: Арнольдович, Арнольдовна
Артемий: Артемьевич, Артемьевна
Архип: Архипович, Архиповна
Афанасий: Афанасьевич, Афанасьевна
Болеслав: Болеславович, Болеславовна
Вацлав: Вацлавович, Вацлавовна
Велимир: Велимирович, Велимировна
Вениамин: Вениаминович, Вениаминовна
Вилен: Виленович, Виленовна
Виссарион: Виссарионович, Виссарионовна
Владлен: Владленович, Владленовна
Вольдемар: Вольдемарович, Вольдемаровна
Гавриил: Гавриилович, Гаврииловна
Гарри: Гарриевич, Гарриевна
Геннадий: Геннадьевич, Геннадьевна
Генрих: Генрихович, Генриховна
Гораций: Горациевич, Горациевна
Добрыня: Добрынич, Добрынична
Дорофей: Дорофеевич, Дорофеевна
Елисей: Елисеевич, Елисеевна
Емельян: Емельянович, Емельяновна
Еремей: Еремеевич, Еремеевна
Ефим: Ефимович, Ефимовна
Ждан: Жданович, Ждановна
Захария: Захариевич, Захариевна
Зенон: Зенонович, Зеноновна
Иероним: Иеронимович, Иеронимовна
Измаил: Измаилович, Измаиловна
Изот: Изотович, Изотовна
Изяслав: Изяславович, Изяславовна
Илиан: Илианович, Илиановна
Иоанн: Иоаннович, Иоанновна
Иосиф: Иосифович, Иосифовна
Ираклий: Ираклиевич, Ираклиевна
Карл: Карлович, Карловна
Ким: Кимович, Кимовна
Клим: Климович, Климовна
Климент: Климентьевич, Климентьевна
Корней: Корнеевич, Корнеевна
Ксенофонт: Ксенофонтович, Ксенофонтовна
Кузьма: Кузьмич, Кузьминична
Лавр: Лаврович, Лавровна
Лукьян: Лукьянович, Лукьяновна
Любомир: Любомирович, Любомировна
Марат: Маратович, Маратовна
Мартин: Мартинович, Мартиновна
Мстислав: Мстиславович, Мстиславовна
Нестер: Нестерович, Нестеровна
Никанор: Никанорович, Никаноровна
Никодим: Никодимович, Никодимовна
Никон: Никонович, Никоновна
Осип: Осипович, Осиповна
Оскар: Оскарович, Оскаровна
Пантелеймон: Пантелеймонович, Пантелеймоновна
Парамон: Парамонович, Парамоновна
Парфен: Парфенович, Парфеновна
Пимон: Пимонович, Пимоновна
Поликарп: Поликарпович, Поликарповна
Ратмир: Ратмирович, Ратмировна
Ренат: Ренатович, Ренатовна
Рюрик: Рюрикович, Рюриковна
Серафим: Серафимович, Серафимовна
Сергий: Сергиевич, Сергиевна
Теодор: Теодорович, Теодоровна
Тит: Титович, Титовна
Фаддей: Фаддеевич, Фаддеевна
Феликс: Феликсович, Феликсовна
Флор: Флорович, Флоровна
Христофор: Христофорович, Христофоровна
Эммануил: Эммануилович, Эммануиловна
Якуб: Якубович, Якубовна